#######
#S....#
#.#####
#.#...#
#.#.#.#
#.#.#.#
#..E..#
#######




